3333333333
3300003003
3300000003
3003000003
3033002303
3000003303
3333300003
3333333333