33333333
30000003
32000303
30000003
30300003
30000033
33333333