33333333
33000003
30003303
30300003
30002033
33333333